15,20,21,15,14,09,01,17,10,10,10,10,10,10,10,10,10,10,10,10,10,10,10,10,10,10,10,21,15,15
09,17,13,09,02,09,07,16,15,20,10,10,10,10,10,10,10,10,10,21,15,15,15,15,15,15,15,14,09,09
09,16,14,00,18,11,12,07,02,16,20,10,10,10,10,10,10,10,10,13,09,09,09,09,09,09,09,09,09,09
09,09,07,00,17,10,19,12,04,09,17,10,10,10,10,10,10,10,10,19,11,11,12,09,09,00,03,09,18,11
09,09,00,00,16,15,15,14,09,18,22,10,10,10,10,10,10,10,10,10,10,21,14,09,08,03,09,18,22,10
12,09,05,04,08,01,02,09,18,22,10,10,10,10,10,10,10,10,10,10,10,13,09,08,00,03,18,22,10,10
13,09,09,09,07,00,00,03,16,15,15,20,10,10,10,10,10,10,10,10,10,13,09,00,00,09,16,15,20,10
19,11,12,09,00,00,00,03,09,09,09,16,15,15,20,10,10,10,10,10,21,14,09,07,03,09,09,09,17,21
10,10,19,11,11,11,11,11,11,12,09,09,09,09,17,10,10,21,15,15,14,09,18,12,09,09,09,09,16,14
10,10,10,10,10,10,10,10,10,19,12,09,02,09,16,15,15,14,09,09,09,18,22,19,12,09,09,09,09,09
10,10,10,10,10,10,10,10,10,10,13,09,06,09,09,09,09,09,09,18,11,22,10,10,19,11,12,09,07,00
10,10,10,10,10,10,10,10,10,10,13,09,09,09,09,08,01,02,09,17,10,10,10,10,10,10,19,12,07,00
10,10,10,10,10,10,10,10,10,21,14,09,01,02,09,06,04,09,09,16,10,10,10,10,10,10,21,14,06,00
10,10,10,10,10,10,10,21,15,14,09,08,00,03,18,12,09,09,09,09,16,15,20,10,10,21,14,09,09,06
21,15,20,10,10,10,10,13,09,09,00,00,00,04,17,19,11,12,09,09,09,09,16,15,15,14,09,09,09,18
13,09,16,20,10,10,10,13,09,00,00,00,00,09,17,10,10,19,11,12,09,09,09,09,01,01,01,09,18,22
13,01,09,17,10,10,10,13,09,00,00,00,04,18,22,10,10,10,10,19,11,12,09,09,06,00,00,09,17,10
13,05,04,17,10,10,10,13,09,09,06,04,09,17,10,10,10,10,10,10,10,19,11,11,12,09,09,18,22,10
19,11,11,22,10,10,10,19,12,18,12,09,18,22,10,10,10,10,10,10,10,10,10,10,19,11,11,22,10,10
10,10,10,10,10,10,10,10,19,22,19,11,22,10,10,10,10,10,10,10,10,10,10,10,10,10,10,10,10,10

0,0,0,0,0,0,0,0,1,1,0,0,0,0,0,0,0,0,0,1,1,1,1,1,1,1,1,0,0,0
0,0,0,0,0,0,0,0,0,0,1,0,0,0,0,0,0,0,1,0,0,0,0,0,0,0,0,0,0,0
0,0,0,0,0,0,0,0,0,0,0,1,0,0,0,0,0,0,1,0,0,0,0,0,0,0,0,0,0,0
0,0,0,0,0,1,0,0,0,0,0,1,0,0,0,0,0,0,1,0,0,0,0,0,0,0,0,0,0,0
0,0,0,0,0,0,0,0,0,0,0,1,0,0,0,0,0,0,0,1,1,0,0,0,0,0,0,0,0,1
0,0,0,0,0,0,0,0,0,0,1,1,0,0,0,0,0,0,0,0,1,0,0,0,0,0,0,0,1,0
0,0,0,0,0,0,0,0,0,0,0,0,1,1,1,0,0,0,0,0,1,0,0,0,0,0,0,0,0,1
0,0,0,0,0,0,0,0,0,0,0,0,0,0,0,1,0,1,1,1,0,0,0,0,0,0,0,0,0,0
1,1,0,0,0,0,0,0,0,0,0,0,0,0,0,1,1,0,0,0,0,0,0,0,0,0,0,0,0,0
0,0,1,1,1,1,1,1,1,0,0,0,0,0,0,0,0,0,0,0,0,0,0,0,0,0,0,0,0,0
0,0,0,0,0,0,0,0,0,1,0,0,0,0,0,0,0,0,0,0,0,0,1,1,0,0,0,0,0,0
0,0,0,0,0,0,0,0,0,1,0,0,0,0,0,0,0,0,0,0,1,1,0,0,1,1,0,0,0,0
0,0,0,0,0,0,0,1,1,0,0,0,0,0,0,0,0,0,0,0,0,0,1,0,0,1,0,0,0,0
0,0,0,0,0,0,1,0,0,0,0,0,0,0,0,0,0,0,0,0,0,0,0,1,1,0,0,0,0,0
0,0,0,0,0,0,1,0,0,0,0,0,0,0,0,0,0,0,0,0,0,0,0,0,0,0,0,0,0,0
0,0,0,0,0,0,1,0,0,0,0,0,0,0,0,1,1,0,0,0,0,0,0,0,0,0,0,0,0,0
0,0,0,0,0,0,1,0,0,0,0,0,0,0,0,1,0,1,1,0,0,0,0,0,0,0,0,0,0,1
0,0,0,0,0,0,1,0,0,0,0,0,0,0,1,0,0,0,0,1,1,0,0,0,0,0,0,0,0,1
0,0,0,0,0,0,1,0,0,0,0,0,0,0,1,0,0,0,0,0,0,1,1,1,0,0,0,0,1,0
0,0,0,0,0,0,0,1,0,0,0,0,0,1,0,0,0,0,0,0,0,0,0,0,1,1,1,1,0,0

